..######
#..#####
##..####
###..###
####...#
#####..#
######..
#######.
\robot 0 7
